R 1900 900
NO ./textures/redbrick.xpm

SO ./textures/purplestone.xpm
WE ./textures/bluestone.xpm
EA ./textures/greystone.xpm
S ./textures/barrel.xpm

F 102,102,102
C 51,51,51

  111
  101
11101
10001
10201
12001
10001
10001
10N01
10001
11111